WWWWWWWWWWWWWWWWWWWW
WEEEEEEEEEEEEEEEEEEW
WEEEEEEEEEEEEEEEEEEW
WWWWWWWWWWWWWWWWEEEW
WEEEEEEEEEEEEEEEEEEW
WEEEEEEEEEEEEEEEEEEW
WEEEWWWWWWWWWWWWWWWW
WEEEEEEEEEEEEEEEEEEW
WEEEEEEEEEEEEEEEEEEW
WEEEEEEEEEEEEEEEEEEW
WWWWWWWWWWWWWWWWEEEW
WEEEEEEEEEEEEEEEEEEW
WEEEEEEEEEEEEEEEEEEW
WEEEWWWWWWWWWWWWWWWW
WEEEEEEEEEEEEEEEEEEW
WEEEEEEEEEEEEEEEEEEW
WWWWWWWWWWWWWWWWEEEW
WEEEEEEEEEEEEEEEEEEW
WEEEEEEEEEEEEEEEEEEW
WWWWWWWWWWWWWWWWWWWW
1 1
1